--------------------------DOM-Q------------Unreal Tournament----------------------------BY NelizMastr-------------

------------------------------------------------------------------------------------------------------------------

What's New?


- Textures

- The Map itself

------------------------------------------BUGS--------------------------------------------------------------------

- K N O W N -  - B U G S -----------------------------------------------------------------------------------------


Sometimes the BOT's camp on the stairs leading to the room with the Big Keg and the Upper Room Controlpoint.


------------------------------------------------------------------------------------------------------------------

-----------------------------------------------INSTALLATION-------------------------------------------------------

Drag the   DOM-Q.unr  to your UnrealTournament\Maps directory. Have FUN.

------------------------------------------------------------------------------------------------------------------

COPYRIGHT

Copyright 2008   NelizMastr Mapping.

Copyright 1999   Epic Games and GT Interactive    (UT99)